pid,burst_time,arrival_time,admitted_time,terminated_time,waiting_time,turnaround_time
1,3,2,2,9,4,7
2,4,3,3,22,15,19
3,5,4,5,37,28,32
4,6,5,7,51,40,44
5,7,6,9,60,47,51
6,8,7,11,68,53,57
7,9,8,13,76,59,63
8,10,9,15,81,62,66
11,13,12,18,91,66,73
12,14,13,20,94,67,74
13,15,14,22,96,67,74
