pid,burst_time,arrival_time,admitted_time,terminated_time,waiting_time,turnaround_time
1,3,2,1,19,14,18
2,4,3,2,55,48,53
3,5,4,4,83,74,79
4,6,5,4,105,94,101
5,7,6,6,123,110,117
6,8,7,6,137,122,131
7,9,8,8,149,132,141
8,10,9,8,159,140,151
9,11,10,10,167,146,157
10,12,11,10,173,150,163
11,13,12,12,177,152,165
